C,C,C,C,C,R,C,R
C,M,C,M,C,M,C,R
C,C,C,C,C,C,C,R
C,M,C,M,C,M,C,R
C,C,R,M,C,C,C,R
C,C,M,C,C,M,C,R
R,C,R_s,C,C,C,C,R