C,C,C,C,C,R,C
C,M,C,M,C,M,C
R_s,C,C,C,C,C,C
C,M,C,M,C,M,C
C,C,R,M,C,R,C
C,C,M,C,C,M,C
R,C,R,C,C,C,C