M,M,M,M,M,M,M,M,M,M
M,C_b,C,C,C,C,C,R,C,M
M,R,C,M,R,R,C,C,C,M
M,C,C,C,M,C,C,R,C,M
M,M,C,C,C,C,C,C,C,M
M,C,C,R,M,C,M,C,C,M
M,C,C,C,C,C,M,C,C,M
M,C,C,M,R,C,M,R_s,C,M
M,C,C,C,C,C,C,C,C_g,M
M,M,M,M,M,M,M,M,M,M